S S S S S S S S S S S S S S S S S S S S S S S S S S S S
S S S S S S S S S S S S S S S S S S S S S S S S S S S S
S S S S S S S S S S S S S S S S S S S S S S S S S S S S 
X X X X X X X X X X X X X X X X X X X X X X X X X X X X 
X X X X X X X X X X X X X X X X X X X X X X X X X X X X
X . . . . . . . . . . . . X X . . . . . . . . . . . . X
X . X X X X . X X X X X . X X . X X X X X . X X X X . X
X + X S S X . X S S S X . X X . X S S S X . X S S X + X
X . X X X X . X X X X X . X X . X X X X X . X X X X . X
X . . . . . . . . . . . . . . . . . . . . . . . . . . X
X . X X X X . X X . X X X X X X X X . X X . X X X X . X
X . X X X X . X X . X X X X X X X X . X X . X X X X . X
X . . . . . . X X . . . . X X . . . . X X . . . . . . X
X X X X X X . X X X X X E X X E X X X X X . X X X X X X
S S S S S X . X X X X X E X X E X X X X X . X E E E E E
S S S S S X . X X E E E E E E E E E E X X . X E E E E E
S S S S S X . X X E X X X = = X X X E X X . X E E E E E
X X X X X X . X X E X G G G G G G X E X X . X X X X X X
t E E E E E . E E E X G G G G G G X E E E . E E E E E T
X X X X X X . X X E X G G G G G G X E X X . X X X X X X
S S S S S X . X X E X X X X X X X X E X X . X S S S S S
S S S S S X . X X E E E E E E E E E E X X . X S S S S S
S S S S S X . X X E X X X X X X X X E X X . X S S S S S
X X X X X X . X X E X X X X X X X X E X X . X X X X X X
X . . . . . . . . . . . . X X . . . . . . . . . . . . X
X . X X X X . X X X X X . X X . X X X X X . X X X X . X
X . X X X X . X X X X X . X X . X X X X X . X X X X . X
X + . . X X . . . . . . . . . . . . . . . . X X . . + X
X X X . X X . X X . X X X X X X X X . X X . X X . X X X
X X X . X X . X X . X X X X X X X X . X X . X X . X X X
X . . . . . . X X . . . . X X . . . . X X . . . . . . X
X . X X X X X X X X X X . X X . X X X X X X X X X X . X
X . X X X X X X X X X X . X X . X X X X X X X X X X . X
X . . . . . . . . . . . . . . . . . . . . . . . . . . X
X X X X X X X X X X X X X X X X X X X X X X X X X X X X
X X X X X X X X X X X X X X X X X X X X X X X X X X X X